6
16 10
1111111111111111
1000000000000001
1000000000000001
1100000000000011
1100000000000011
1000001111000001
1000011111100001
100011111111000F
1001111111111001
1111111111111111
20 12
11111111111111111111
11100000000000000111
11000000000000000011
10000000000000000001
10000000000000000001
10000000000000000001
11000000000000000011
11000000000000000011
10000000000000000001
T0000000000000000001
10000000000000000001
11111111111111111111
12 8
111111111111
111111111111
111110011111
111000000111
100000000001
T0000000000F
10A00A00A001
111111111111
12 10
111111111111
100000000001
100000C00001
100111111001
100110011001
100110011001
100111111001
T0000000000F
100A00B00A01
111111111111
12 10
111111111111
110011110011
100000000001
100000000001
1100B00B0011
110011110011
110011110011
T0001111000F
100011110001
111111111111
12 12
111111111111
11000000000F
110000000C01
110011111111
110011111111
110000000011
11C000000011
111111110011
111111110011
T00000000011
100000000C11
111111111111