3
12 10
111111111111
100000000001
100000000001
100000000001
100000000001
100000000001
100000000001
T0000000000F
10A00B00C001
111111111111
12 10
111111111111
100000000001
100000000001
100110011001
100111111001
100111111001
100111111001
T0000000000F
10A00B00C001
111111111111
12 10
111111111111
100011110001
100000000001
100000000001
1000B00B0001
100011110001
100011110001
T0001111000F
100011110001
111111111111