3
12 10
111111111111
100000000001
100000000001
100000000001
100000000001
100000000001
100000000001
000000000000
100000000001
111111111111
12 10
111111111111
100000000001
100000000001
100110011001
100111111001
100111111001
100111111001
000000000000
100000000001
111111111111
12 10
111111111111
100011110001
100000000001
100000000001
100000000001
100011110001
100011110001
000011110000
100011110001
111111111111